13 11
570 260
10 5 5 5 5 5 5 5 5 5 5 5 8
4 1 1 1 1 1 1 1 1 1 1 1 3
4 1 1 1 1 1 1 1 1 1 1 1 3
4 0 0 0 0 0 0 0 0 0 0 0 3
4 2 2 2 2 2 2 2 2 2 2 2 3
4 2 2 2 2 2 2 2 2 2 2 2 3
4 2 2 2 2 2 2 2 2 2 2 2 3
4 2 2 2 2 2 2 2 2 2 2 2 3
4 2 2 2 2 2 2 2 2 2 2 2 3
4 2 2 2 2 2 2 2 2 2 2 2 3
7 6 6 6 6 6 6 6 6 6 6 6 9