13 11
570 260
22 17 17 17 17 17 17 17 17 17 17 17 20
16 13 13 13 13 13 13 13 13 13 13 13 15
16 13 13 13 13 13 13 13 13 13 13 13 15
16 12 12 12 12 12 12 12 12 12 12 12 15
16 14 14 14 14 14 14 14 14 14 14 14 15
16 14 14 14 14 14 14 14 14 14 14 14 15
16 14 14 14 14 14 14 14 14 14 14 14 15
16 14 14 14 14 14 14 14 14 14 14 14 15
16 14 14 14 14 14 14 14 14 14 14 14 15
16 14 14 14 14 14 14 14 14 14 14 14 15
19 18 18 18 18 18 18 18 18 18 18 18 21